xtggggggggggggggggggggggggggggggggghl
yuaddaadaaadaaadadaaaaddadaddaaadadim
zvbeebbebbbebbbebebbbbeebebeebbbebejn
Awcffccfcccfcccffccfcfcfcccfcfcfffcko
BC000000000000000000000000000000000qp
DE000000000000000000000000000000000qp
BC000120344444444444444444444500000sr
DE000000344444444444444444444500000qp
BC000000344444444444444444444500000sr
FG000000000000000000000000000000000KL
HIJJJJJJJJJJJJJJJJJJJJJJJJJJJJJJJJJMN